6 6 6 6 6 6 7 8 6 6 0 0 0 0 0 0 0 0
0 0 0 0 0 0 0 0 0 0 0 0 0 0 0 0 0 0
0 1 1 1 0 1 0 0 0 0 0 0 0 0 0 0 0 0
0 1 0 1 0 1 0 0 2 2 0 0 0 0 0 0 0 0
0 1 0 1 0 1 0 0 2 5 0 0 0 0 0 0 0 0
0 1 0 1 0 1 0 0 2 5 0 0 0 0 0 0 0 0
0 1 0 1 0 1 0 0 2 2 0 0 0 0 0 0 0 0
0 0 0 0 0 0 0 0 0 0 0 0 0 0 0 0 0 0
3 3 0 0 0 0 0 0 4 4 0 0 0 0 0 0 0 0
3 3 0 0 0 0 0 0 4 4 0 0 0 0 0 0 0 0
3 3 0 0 0 0 0 0 4 4 0 0 0 0 0 0 0 0
3 3 0 0 0 0 0 0 4 4 0 0 0 0 0 0 0 0
3 3 0 0 0 0 0 0 4 4 0 0 0 0 0 0 0 0
3 3 0 0 0 0 0 0 4 4 0 0 0 0 0 0 0 0
3 3 0 0 0 0 0 0 4 4 0 0 0 0 0 0 0 0
