9	6	6	6	6	6	6	6	6	6	6	6	6	7	8	6	6	10
15	0	0	0	0	0	0	0	0	0	0	0	0	0	0	0	0	13
15	0	0  16	0	16	0	16	0	16	0	0	0	0	0	0	0	13
15	0	0  1	0	1	0	1	0	1	0	0	0	0  0	0	0	13
15	0	0	0	0	0	0	0	0	0	0	0	0	0	0	0	0	13
15	0	0  16	0	16	0	16	0	16	0	0	0	0	0	0	0  13
15	0	0	0	1	0	1	0	1	0	0	0	0	0	0	0	0  13
15	0	0	0	0	0	0	0	0	0	0	0	0	0	0	0	0	13
15	0	0	0	0	0	0	0	0	0	0	0	0	0	0	0	0	13
15	0	0	0	0	0	0	0	0	0	0	0	0	0	0	0	0	13
15	0	0	0	0	0	0	0	0	0	0	0	0	0	0	0	0	13
15	0	0	0	0	0	0	0	0	0	0	0	0	0	0	0	0	13
15	1	1	1	1	0	0	0	0	0	0	0	0	0	0	0	0	13
15	1	1	1	1	0	0	0	0	0	0	0	0	0	0	0	0	13
11	14	41	42	43	14	14	14	14	14	14 14 14 14 14 14 14 12
