9	6	6	6	6	6	6	6	6	6	6	6	6	6	6	6	6	10
15	0	0	0	0	0	0	0	0	0	0	0	0	0	0	0	0	13
15	1	1	1	0	1	0	0	0	0	0	0	0	0	0	0	0	13
15	1	0	1	0	1	0	0	2	2	0	0	0	0	0	0	0	13
15	1	0	1	0	1	0	0	2	5	0	0	0	0	0	0	0	13
15	1	0	1	0	1	0	0	2	5	0	0	0	0	0	0	0	13
15	1	0	1	0	1	0	0	2	2	0	0	0	0	0	0	0	13
15	0	0	0	0	0	0	0	0	0	0	0	0	0	0	0	0	13
15	3	0	0	0	0	0	0	4	4	0	0	0	0	0	0	0	13
15	3	0	0	0	0	0	0	4	4	0	0	0	0	0	0	0	13
15	3	0	0	0	0	0	0	4	4	0	0	0	0	0	0	0	13
15	3	0	0	0	0	0	0	4	4	0	0	0	0	0	0	0	13
15	3	0	0	0	0	0	0	4	4	0	0	0	0	0	0	0	13
15	3	0	0	0	0	0	0	4	4	0	0	0	0	0	0	0	13
11	14	14	14	14	14	14	14	14	14	14 14 14 14 14 14 14 12
